0200000002000000020000020
0200000002000000020000020
1413111114111111141111141
0202000002000000020000020
0203113113111111130000020
0200002002000000020000020
1411113113131.13131131141
020000200002...2000020020
020000200002...2000020020
1411113113131313131131141
0200000002000200020000020
0311300002000311130000020
0200200002000000020000020
1411311114111111141111141
0200000002000000020000020